1 3 3 3 3 3 3 3 3 3 3 3 3 3 3 3
1 3 3 3 3 3 3 3 3 3 3 3 3 3 3 3
1 1 1 1 1 1 1 1 3 3 3 3 3 3 3 3
0 1 5 0 3 4 4 1 1 1 1 1 1 3 3 3
0 1 5 3 2 3 3 2 3 3 0 3 1 1 1 2
0 1 5 3 1 3 3 3 3 3 3 3 1 3 4 3
0 1 5 3 1 3 3 3 3 3 3 3 1 4 3 3
2 1 1 1 1 1 1 1 1 1 1 1 1 3 3 3
0 4 4 4 4 2 4 1 4 4 4 4 4 4 3 3
3 3 3 3 3 3 3 1 3 3 3 3 3 3 3 3
3 3 3 3 3 3 3 1 3 3 3 3 3 3 3 3
3 3 3 3 3 3 3 1 3 3 3 3 3 3 3 3